XXXXXXXXXXXXXXXXXXXXXXXXXXXXXX
X<OOOOOOOOOXOOOXOOOOXOOOXOOOOX
XXXXXXXXXXOXOOOXOXXOXOXOXXXXOX
XOOOXXXXXXOXOOOOOXXOXOXOOOOOOX
XOOOXOOOXXOXOOOXXXXOXOXXXXXDXX
XOOODOOOOOOXOOOXOOXOXOXOXXOOOX
XOOOXOOOXXXXXXXXXOXOXOXOODOOOX
XXXXXXOXXXXXXXXXXOXOXOXOXXOOOX
XOOOOOOOOOOOOOOOOOOOXOXOXXXXXX
XOXXXXOXXXXXXXXXXXXOSOXOXXOOOX
XOXOOOOOOOOOOOOOOOXOXOXOODOOOX
XOXOOOOOOOXXXXXXXOXOXOXOXXOOOX
XOXOOOOOOOXOOOOOXOXOXOXOXXXXXX
XOXOOOOOOOXOOOOOXOXOXOXOXXOOOX
XXXXXXOXXXXXXXXDXOOOXOXOODOOOX
XOOOXXOXXOOOXXXOXOXOXOXOXXOOOX
XOOOXXOXXOOOOOXOXOXOXOXOXXXXXX
XOOOXOOOSOOOXOOOOOXOXXXOXXXXOX
XXOXXOOOXXXXXXXOXOXOSOOOOOOOOX
XXOOXXOXXOXXXXXOXOXOXXXXXXXXXX
XXXOXX>XXOOOOOOOXOXOXXXXXXXXXX
XOXOXXXXXXXXXOXXXOXOXXXXXXXXXX
XOOOOOOOOOOOOOOXOOXXXXXXXXXXXX
XXXXXXXXXXXXXXXXXXXXXXXXXXXXXX
XXXXXXXXXXXXXXXXXXXXXXXXXXXXXX
XXXXXXXXXXXXXXXXXXXXXXXXXXXXXX
XXXXXXXXXXXXXXXXXXXXXXXXXXXXXX
XXXXXXXXXXXXXXXXXXXXXXXXXXXXXX
XXXXXXXXXXXXXXXXXXXXXXXXXXXXXX
XXXXXXXXXXXXXXXXXXXXXXXXXXXXXX
