XXXXXXXXXXXXXXXXXXXXXXXXXXXXXX
X>OOOOOOOSOOOOXOXOOOXOOOOOOX<X
XXXXXOXXXXXXXOOOSOXOXOXOXXOXOX
XOOOXOXOOOXOOOXOXOSOXOSOSOOSOX
XOXOXOXOXOXXXOXOOOXOOOXOXXOXOX
XOXOXOXOXOOOXOXXXOXOXOXOOOOXOX
XOXOXOXOXOXOXOXOXOXOXOXXXXOXOX
XOXOOOOOXOXOOOXOOOXOXOOOOXOXOX
XOXXXXXOXOXXXXXXXXXXXXXXOOOOOX
XOOOOOOOXOOOOOOOOOOOOXOOOXOXXX
XXXXXXXXXXXXXXXXXOXXXXXXXXXXOX
XXXOOOXOOOXOOXOOOOOOOXOOOOOOOX
XOXOXOXOXOXXOXOXXXXXODOXXXXXXX
XOOOXOOOXOOOOOOOOOOXOXOOOOOOOX
XXXXXXXXXXXXXXXXXXXXXXXXXXXXXX
XXXXXXXXXXXXXXXXXXXXXXXXXXXXXX
XXXXXXXXXXXXXXXXXXXXXXXXXXXXXX
XXXXXXXXXXXXXXXXXXXXXXXXXXXXXX
XXXXXXXXXXXXXXXXXXXXXXXXXXXXXX
XXXXXXXXXXXXXXXXXXXXXXXXXXXXXX
XXXXXXXXXXXXXXXXXXXXXXXXXXXXXX
XXXXXXXXXXXXXXXXXXXXXXXXXXXXXX
XXXXXXXXXXXXXXXXXXXXXXXXXXXXXX
XXXXXXXXXXXXXXXXXXXXXXXXXXXXXX
XXXXXXXXXXXXXXXXXXXXXXXXXXXXXX
XXXXXXXXXXXXXXXXXXXXXXXXXXXXXX
XXXXXXXXXXXXXXXXXXXXXXXXXXXXXX
XXXXXXXXXXXXXXXXXXXXXXXXXXXXXX
XXXXXXXXXXXXXXXXXXXXXXXXXXXXXX
XXXXXXXXXXXXXXXXXXXXXXXXXXXXXX
